................................................................
................................................................
................................................................
................................................................
.......................########.................................
.....BB?BBBB?BB.......###..............#.#......................
....................###................#.#......................
...................####.........................................
GGGGGGGGGGGGG..GGGGGGGGGGGGGGGGGGGGG.##############.....########
...................................#.#...............###........
........................############.#............###...........
........................#............#.........###..............
........................#.############......###.................
........................#................###....................
........................#################.......................
................................................................
................................................................
.......ooooo....................................................
........ooo..................P..................................
.......................########.................................
.....BB?BBBB?BB.......###..............#.#......................
....................###................#.#......................
..V..........C.....####.M........................V.........S....
GGGGGGGGGGGGGGGGGGGGGGGGGGGGGGGGGGGG.##############.....########
...................................#.#...............###........
........................############.#............###...........
........................#......(.....#.........###..............
........................#.############......###.................
........................#................###....................
........................#################.......................
GGGGGGGGGGGGGGGGGGGGGGGGGGGGGGGGGGGGGGGGGGGGGGGGGGGGGGGGGGGGGGGG