GGGGGGGGGGGGG..GGGGGGGGGGGGGGGGGGGGG.##############.....########
. P.................................#.#...............###........
........................############.#............###...........
........................#............#.........###..............
........................#.############......###.................
........................#................###....................
........................#################.......................
................................................................
................................................................
.......ooooo....................................................
........ooo.....................................................
........V..............########.................................
.....BB?BBBB?BB.......###..............#.#......................
....................###....oo..........#.#......................
...o.........C.....####...ooo..............................S....
GGGGGGGGGGGGGGGGGGGGGGGGGGGGGGGGGGGG.##############.....########
...................................#.#...............###........
........................############.#............###...........
........................#......(.....#.........###..............
........................#.############......###.................
........................#................###....................
........................#################.......................
GGGGGGGGGGGGGGGGGGGGGGGGGGGGGGGGGGGGGGGGGGGGGGGGGGGGGGGGGGGGGGGG